-- level comments goes here --
-- player start info goes here --
 
-- Tiles --
5 0 0 -2 0 1 0 0 0 11 0
5 0 0 -2 0 1 -2 0 0 11 0
5 0 0 0 0 1 0 0 0 11 0
5 0 0 0 0 1 -2 0 0 11 0
5 0 0 -2 0 1 0 0 0 9 0
5 0 0 -2 0 1 0 0 0 10 0
5 0 0 -2 0 1 0 0 0 8 0
5 0 0 -2 0 1 0 0 0 7 0
5 0 0 -2 0 1 0 0 0 6 0
5 0 0 -4 0 1 0 0 0 6 0
5 0 0 -2 -2 1 0 0 0 6 0
5 0 44 -4 -2 1 0 0 0 6 0
2 0 0 -10 -4 1 0 0 0 0 0
1 6 0 -12 -4 1 0 0 0 0 0
1 2 33 -16 -4 1 0 0 0 0 0
1 3 33 -18 -4 1 0 0 0 0 0
1 6 0 -13 -4 0 0 1 0 0 0
1 3 44 -17 -4 0 0 1 0 0 0
0 6 0 -10 -4 3 0 0 0 0 0
1 0 0 -14 -4 1 0 0 0 0 0
1 0 0 -15 -4 0 0 1 0 0 0
1 0 0 -19 -4 0 0 1 0 0 0
1 0 0 -20 -4 1 0 0 0 0 0
1 0 0 -21 -4 0 0 1 0 0 0
1 0 0 -11 -4 0 0 1 0 0 0
1 0 0 -9 -4 0 0 1 0 0 0
1 0 0 -5 -4 0 0 5 0 2 0
1 0 0 -3 -4 0 0 9 0 2 0
1 0 0 0 -4 -1 0 10 0 2 0
1 0 0 -1 -4 0 0 13 0 2 0
1 0 0 0 -4 -3 0 12 0 2 0
1 0 0 0 -4 -1 0 16 0 2 0
1 0 0 0 -4 -5 0 14 0 2 0
1 0 0 0 -4 -3 0 18 0 2 0
1 0 0 -3 -4 0 0 3 0 2 0
1 0 0 -20 -4 1 0 0 0 2 0
1 0 0 -21 -4 0 0 1 0 2 0
1 0 0 -20 -4 3 0 0 0 2 0
1 0 0 -22 -4 1 0 0 0 2 0
3 0 0 -16 -4 3 0 0 0 2 0
3 0 0 -14 -4 7 0 0 0 2 0
3 0 0 -12 -4 5 0 0 0 2 0
3 0 0 -10 -4 9 0 0 0 2 0
3 0 0 -6 -4 11 0 0 0 2 0
2 0 0 -18 -4 9 0 0 0 10 0
2 0 0 -14 -4 13 0 0 0 8 0
2 0 0 -10 -4 13 0 0 0 6 0
2 0 0 -18 -4 9 0 0 0 8 0
0 0 0 -22 -4 5 0 0 0 10 0
1 0 0 -1 -4 0 0 7 0 2 0
0 2 0 -9 -4 0 0 1 0 10 0
1 2 0 -7 -4 0 0 3 0 8 0
1 2 0 -5 -4 0 0 7 0 8 0
1 2 0 -3 -4 0 0 11 0 8 0
1 2 0 -1 -4 0 0 15 0 8 0
1 2 0 0 -4 -3 0 10 0 8 0
1 2 0 0 -4 -1 0 8 0 8 0
1 2 0 -1 -4 0 0 5 0 8 0
1 2 0 -3 -4 0 0 1 0 8 0
1 0 0 -9 -4 0 0 1 0 8 0
1 0 0 -7 -4 0 0 5 0 8 0
1 0 0 -5 -4 0 0 9 0 8 0
1 0 0 -3 -4 0 0 13 0 8 0
1 0 0 0 -4 -3 0 8 0 8 0
1 0 0 0 -4 -1 0 6 0 8 0
1 0 0 -1 -4 0 0 3 0 8 0
1 2 0 0 -4 -1 0 4 0 8 0
1 2 0 0 -4 -3 0 6 0 8 0
1 2 0 -5 -4 0 0 11 0 8 0
1 2 0 -7 -4 0 0 7 0 8 0
1 2 0 -9 -4 0 0 3 0 8 0
1 0 0 -9 -4 0 0 5 0 8 0
1 0 0 -7 -4 0 0 9 0 8 0
1 0 0 0 -4 -3 0 4 0 8 0
1 2 0 -9 -4 0 0 7 0 8 0
2 2 0 0 -4 -7 0 14 0 6 0
0 2 0 0 -4 -5 0 16 0 4 0
0 2 0 0 -4 -9 0 14 0 4 0
4 2 0 0 -2 -9 0 14 0 4 0
4 2 0 0 0 -9 0 14 0 4 0
4 2 0 0 2 -9 0 14 0 4 0
4 2 0 0 -4 -11 0 14 0 1 0
4 2 0 0 -2 -11 0 14 0 1 0
4 2 0 0 0 -11 0 14 0 1 0
2 2 0 0 -4 -7 0 18 0 0 0
0 2 0 0 -4 -5 0 18 0 10 0
0 2 0 0 2 -9 0 14 0 10 0
0 2 0 0 2 -9 0 12 0 8 0
0 2 0 0 2 -9 0 12 0 6 0
0 2 0 0 2 -11 0 10 0 6 0
1 2 0 0 2 -13 0 8 0 6 0
1 2 0 0 2 -15 0 6 0 6 0
1 2 0 0 2 -17 0 4 0 6 0
1 2 0 0 2 -17 0 2 0 6 0
1 2 0 0 2 -17 0 0 0 6 0
1 2 0 2 2 -15 0 0 0 6 0
1 2 0 0 2 -15 0 2 0 4 0
1 2 0 0 2 -13 0 4 0 4 0
0 2 0 0 2 -15 0 2 0 2 0
4 1 0 0 0 -13 -2 8 0 0 1
4 1 0 0 0 -15 -2 6 0 0 1
4 1 0 0 0 -11 -2 10 0 0 1
4 1 0 0 0 -9 -2 12 0 0 1
1 1 0 0 0 -9 0 12 2 1 1
1 1 0 0 -2 -9 0 12 2 1 1
1 1 0 0 -4 -9 0 12 2 1 1
1 1 0 0 -6 -9 0 12 2 1 1
5 1 0 0 -6 -9 0 14 2 2 1
5 1 0 0 -6 -9 0 16 2 2 1
5 1 0 0 -6 -9 0 18 2 2 1
5 1 0 0 -6 -9 0 20 2 2 1
0 6 0 0 -6 -9 0 18 0 6 1
0 6 0 0 -6 -7 0 18 0 6 1
0 6 0 0 -6 -9 0 16 0 6 1
0 6 0 0 -6 -9 0 18 0 4 1
0 6 0 0 -6 -7 0 18 0 4 1
0 6 0 0 -6 -9 0 16 0 4 1
2 3 55 0 -2 -7 5 20 0 0 1
5 1 0 0 -6 -7 0 20 0 9 1
5 1 0 0 -6 -5 0 20 0 9 1
5 1 0 0 -6 -3 0 20 0 9 1
5 1 0 0 -6 -1 0 20 0 9 1
1 1 0 0 -6 -1 2 20 0 9 1
1 1 0 0 -6 -1 4 20 0 9 1
1 1 0 0 -6 -1 6 20 0 9 1
1 1 0 0 -6 -1 8 20 0 9 1
1 1 0 0 -4 -1 4 20 0 9 1
1 1 0 0 -2 -1 6 20 0 9 1
1 1 0 0 0 -1 8 20 0 9 1
1 1 0 0 -4 -1 6 20 0 9 1
1 1 0 0 -4 -1 8 20 0 9 1
1 1 0 0 -2 -1 8 20 0 9 1
4 0 55 0 2 -17 0 4 -2 6 1
3 2 55 0 2 -17 0 4 -2 2 1
0 6 0 0 0 -22 0 1 0 0 1
0 6 0 0 0 -20 0 3 0 0 1
0 6 0 1 0 -23 0 0 0 0 1
0 6 0 3 0 -23 0 0 0 0 1
0 6 0 5 0 -23 0 0 0 0 1
3 6 0 5 0 -21 0 0 0 0 1
3 6 0 0 0 -22 0 5 0 0 1
3 6 0 0 0 -26 0 1 0 0 1
3 6 0 3 0 -27 0 0 0 0 1
3 6 0 0 0 -26 0 5 0 0 1
3 6 0 0 0 -30 0 1 0 0 1
3 6 0 0 0 -30 0 5 0 0 1
0 0 0 3 0 -21 0 0 0 0 1
0 0 0 5 0 -17 0 0 0 10 1
0 0 0 7 0 -15 0 0 0 8 1
0 0 0 7 0 -15 0 0 0 2 1
0 0 0 9 0 -11 0 0 0 2 1
0 0 0 7 0 -13 0 0 0 0 1
0 0 0 9 0 -9 0 0 0 0 1
0 0 0 11 0 -5 0 0 0 10 1
0 0 0 13 0 -3 0 0 0 8 1
0 0 0 13 0 -1 0 0 0 10 1
0 0 0 14 0 0 0 -1 0 8 1
0 0 0 12 0 0 0 -3 0 10 1
0 0 0 12 0 0 0 -5 0 8 1
0 0 0 9 0 -19 0 0 0 8 1
0 0 0 11 0 -17 0 0 0 6 1
0 0 0 11 0 -17 0 0 0 4 1
0 0 0 11 0 -15 0 0 0 2 1
0 0 0 11 0 -13 0 0 0 0 1
0 0 0 13 0 -9 0 0 0 10 1
0 0 0 15 0 -7 0 0 0 8 1
0 0 0 17 0 -5 0 0 0 6 1
0 0 0 17 0 -3 0 0 0 8 1
0 0 0 19 0 -1 0 0 0 6 1
0 0 0 18 0 0 0 -1 0 8 1
0 0 0 18 0 0 0 -3 0 6 1
0 0 0 16 0 0 0 -5 0 8 1
3 6 0 9 0 -13 0 0 0 8 1
3 6 0 11 0 -9 0 0 0 8 1
3 6 0 13 0 -5 0 0 0 8 1
3 6 0 15 0 -1 0 0 0 8 1
3 6 0 14 0 0 0 -3 0 8 1
2 5 0 16 0 0 0 -5 0 6 1
0 0 0 1 0 -23 0 0 0 6 1
0 0 0 5 0 -23 0 0 0 6 1
0 0 0 0 0 -26 0 1 0 4 1
0 0 0 3 0 -27 0 0 0 4 1
0 0 0 0 0 -28 0 1 0 2 1
0 0 0 0 0 -28 0 3 0 0 1
0 0 0 1 0 -21 0 0 0 10 1
0 0 0 3 0 -23 0 0 0 2 1
0 0 0 5 0 -21 0 0 0 10 1
0 0 0 7 0 -21 0 0 0 10 1
0 0 0 0 0 -20 0 1 0 10 1
0 0 0 1 0 -19 0 0 0 8 1
0 0 0 0 1 -26 0 13 -24 8 1
0 0 0 0 1 -24 0 15 -24 8 1
0 0 0 0 1 -26 0 13 -24 6 1
2 0 0 0 1 -26 0 11 -24 6 1
2 0 0 0 1 -22 0 15 -24 8 1
5 0 0 3 0 -17 0 0 -2 8 1
5 0 0 0 1 -19 0 4 -24 8 1
5 0 0 0 1 -19 0 4 -22 8 1
5 0 0 0 1 -19 0 4 -20 8 1
5 0 0 0 1 -19 0 4 -26 8 1
5 0 0 0 1 -19 0 4 -26 9 1
5 0 0 0 1 -19 0 4 -24 9 1
5 0 0 0 1 -19 0 4 -22 9 1
5 0 0 0 1 -19 0 4 -20 9 1
5 0 0 0 1 -19 0 4 -18 9 1
5 0 0 0 1 -19 0 4 -16 9 1
5 0 0 0 1 -19 0 4 -14 9 1
5 0 0 0 1 -19 0 4 -12 9 1
5 0 0 0 1 -19 0 4 -18 8 1
5 0 0 0 1 -19 0 4 -16 8 1
3 0 0 20 0 0 0 -3 0 6 1
3 6 0 24 0 0 0 -1 0 6 1
3 6 0 28 0 0 0 -1 0 6 1
3 6 0 30 0 0 0 -3 0 6 1
3 6 0 28 0 0 0 -7 0 6 1
0 6 0 25 0 -3 0 0 0 4 1
0 6 0 18 0 0 -7 -3 0 2 1
0 6 0 28 0 0 0 -1 0 2 1
0 6 0 26 0 0 0 -3 0 0 1
0 6 0 26 0 0 0 -1 0 0 1
0 6 0 26 0 0 0 -7 0 0 1
3 4 2 1 0 -21 0 0 0 0 1
2 0 0 10 0 0 0 -3 0 10 1
0 0 0 0 1 -19 0 4 -26 10 1
2 0 0 6 1 -21 0 0 -26 6 1
2 4 0 0 1 -21 0 2 -26 0 1
5 0 0 0 1 -19 0 4 -26 7 1
5 0 0 0 1 -19 0 4 -26 6 1
5 0 0 0 1 -19 0 4 -26 5 1
5 0 0 0 1 -19 0 4 -26 4 1
5 0 0 0 1 -19 0 4 -26 3 1
5 0 0 0 1 -19 0 4 -26 2 1
0 0 0 0 1 -19 0 4 -26 0 1
0 0 0 0 1 -19 0 2 -26 10 1
0 0 0 6 1 -21 0 0 -26 8 1
0 0 0 8 1 -21 0 0 -26 6 1
0 0 0 8 1 -23 0 0 -26 4 1
0 0 0 8 1 -23 0 0 -26 2 1
0 0 0 8 1 -23 0 0 -26 0 1
0 0 0 7 1 -33 0 0 -26 10 0
0 0 0 5 1 -35 0 0 -26 0 0
0 0 0 7 1 -35 0 0 -26 0 0
1 0 0 3 1 -35 0 0 -26 0 0
1 0 0 1 1 -35 0 0 -26 0 0
1 0 0 9 1 -33 0 0 -26 10 0
1 0 0 11 1 -33 0 0 -26 10 0
1 0 0 3 1 -31 0 0 -26 8 0
1 0 0 1 1 -35 0 0 -26 4 0
1 0 0 0 1 -32 0 1 -26 0 0
1 0 0 3 1 -31 0 0 -26 4 0
1 0 0 1 1 -29 0 0 -26 8 0
1 0 0 5 1 -27 0 0 -26 8 0
1 0 0 7 1 -25 0 0 -26 8 0
1 0 0 1 1 -29 0 0 -26 0 0
1 0 0 3 1 -27 0 0 -26 0 0
1 0 0 13 1 -35 0 0 -26 2 0
1 0 0 13 1 -31 0 0 -26 2 0
1 0 0 15 1 -33 0 0 -26 2 0
1 0 0 17 1 -31 0 0 -26 2 0
1 0 0 7 9 -33 0 0 -27 2 0
1 0 0 13 1 -29 0 0 -26 2 0
1 0 0 13 1 -27 0 0 -26 2 0
1 0 0 15 1 -25 0 0 -26 2 0
1 0 0 17 1 -23 0 0 -26 2 0
1 0 0 19 1 -29 0 0 -26 2 0
1 0 0 21 1 -27 0 0 -26 2 0
1 0 0 21 1 -25 0 0 -26 2 0
1 0 0 21 1 -23 0 0 -26 2 0
1 4 1 21 1 -19 0 0 -26 2 0
1 0 0 15 1 -21 0 0 -26 0 0
1 0 0 21 1 -13 0 0 -26 10 0
1 0 0 19 1 -13 0 0 -26 10 0
1 0 0 17 1 -13 0 0 -26 10 0
1 0 0 15 1 -13 0 0 -26 10 0
1 0 0 13 1 -13 0 0 -26 10 0
1 0 0 11 1 -13 0 0 -26 10 0
1 0 0 9 1 -13 0 0 -26 10 0
1 0 0 7 1 -13 0 0 -26 10 0
1 0 0 5 1 -13 0 0 -26 10 0
1 0 0 3 1 -13 0 0 -26 10 0
1 0 0 1 1 -13 0 0 -26 10 0
1 0 0 0 1 -12 0 1 -26 10 0
1 0 0 0 1 -10 0 3 -26 10 0
1 0 0 0 1 -8 0 5 -26 10 0
1 0 0 0 1 -6 0 7 -26 10 0
1 0 0 0 1 -4 0 9 -26 10 0
1 0 0 0 1 -2 0 11 -26 10 0
1 0 0 0 1 -2 0 11 -26 8 0
1 0 0 0 1 -2 0 13 -26 8 0
1 0 0 0 1 -4 0 13 -26 8 0
1 0 0 13 1 -21 0 0 -26 0 0
1 0 0 11 1 -21 0 0 -26 0 0
1 0 0 9 1 -21 0 0 -26 0 0
1 0 0 7 1 -21 0 0 -26 0 0
1 0 0 5 1 -21 0 0 -26 0 0
1 0 0 3 1 -21 0 0 -26 0 0
1 0 0 1 1 -21 0 0 -26 0 0
1 0 0 0 1 -20 0 1 -26 0 0
1 0 0 0 1 -18 0 3 -26 0 0
1 0 0 0 1 -16 0 5 -26 0 0
1 0 0 0 1 -14 0 7 -26 0 0
1 0 0 0 1 -12 0 9 -26 0 0
1 0 0 0 1 -10 0 11 -26 0 0
1 0 0 0 1 -6 0 15 -26 0 0
1 0 0 0 1 -8 0 13 -26 0 0
5 7 0 17 0 -19 1 0 -27 11 0
5 4 0 0 1 -10 0 9 -26 0 0
0 0 0 0 1 -9 0 6 -26 6 0
0 0 0 0 0 -12 4 7 -28 4 1
0 0 0 0 0 -14 4 5 -28 4 1
0 0 0 0 0 -12 4 7 -28 2 1
0 0 0 0 0 -10 4 7 -28 0 1
0 0 0 0 0 -14 4 5 -26 1 1
0 0 0 0 0 -14 4 5 -24 1 1
0 0 0 0 0 -14 4 5 -26 11 1
0 0 0 0 0 -14 2 5 -26 1 1
0 6 0 0 0 -10 6 9 -26 11 1
0 6 0 0 0 -10 6 9 -24 11 1
0 6 0 0 0 -10 6 9 -26 9 1
0 6 0 0 0 -10 6 9 -26 7 1
3 0 0 0 0 -14 2 5 -26 7 1
1 1 0 0 0 -14 4 5 -24 7 1
1 1 0 0 0 -14 6 5 -22 7 1
1 1 666 0 0 -14 8 5 -20 7 1
1 1 0 0 0 -14 10 5 -18 7 1
1 1 0 0 0 -14 12 5 -16 7 1
1 4 3 0 0 -14 18 5 -14 8 1
1 3 666 0 0 -14 13 5 -12 8 1
0 4 0 0 0 4 0 0 0 6 1
-- End Tiles --
 
-- Checkpoints --
-1 0 0 0 0 -2 0
0 2 -8 0 11 0 0
0 15 0 -4 0 0 1
7 2 -33 0 0 -27 0
0 1 -10 0 7 -26 0
-- End Checkpoints --
 
-- Victories --
0 0 1 1 0 -3 1
-- End Victories --
 
-- Warps --
0 1 4 10 0 -12 -3 0 0 0 1
0 1 0 4 -11 0 12 -1 0 0 1
0 1 0 1 -6 0 12 -26 0 0 1
-- End Warps --
