-- Level Comments go here --
 
-- Layer #0 --
5 0 -2 0 0 0 0 2 11
2 0 -2 0 0 0 0 0 9
1 0 2 0 0 0 0 0 9
0 5 2 2 0 0 0 -2 7
0 2 2 4 0 -2 0 0 7
3 6 2 2 0 -4 0 0 7
2 1 4 2 0 -4 0 0 6
2 1 4 2 0 -4 0 0 9
4 1 2 4 0 -2 0 0 0
5 1 2 2 0 -2 0 0 1
0 0 2 4 0 -2 -2 0 10
3 0 6 2 0 -8 0 0 5
5 0 8 2 0 -8 0 0 5
4 0 -2 0 0 0 0 0 7
2 2 -2 0 2 0 0 0 7
2 6 0 0 0 -2 0 2 6
1 2 0 0 -2 -2 2 4 0
4 6 0 0 0 -2 0 4 6
4 6 2 0 0 -2 0 4 10
0 2 2 0 -2 -2 0 4 0
2 3 4 0 -2 -4 0 4 2
-- Checkpoints --
-- End Layer --
 
-- Warps --
