-- level comments goes here --
-- player start info goes here --

-- Tiles --
5 0 -2 0 0 0 0 2 11 0
4 0 -2 0 0 0 0 0 9 0
3 0 2 0 0 0 0 0 9 0
1 5 2 2 0 0 0 -2 7 0
1 2 2 4 0 -2 0 0 7 0
2 6 2 2 0 -4 0 0 7 0
4 1 4 2 0 -4 0 0 6 0
4 1 4 2 0 -4 0 0 9 0
0 1 2 4 0 -2 0 0 0 0
5 1 2 2 0 -2 0 0 1 0
1 0 2 4 0 -2 -2 0 10 0
2 0 6 2 0 -8 0 0 5 0
5 0 8 2 0 -8 0 0 5 0
0 0 -2 0 0 0 0 0 7 0
4 2 -2 0 2 0 0 0 7 0
4 6 0 0 0 -2 0 2 6 0
3 2 0 0 -2 -2 2 4 0 0
0 6 0 0 0 -2 0 4 6 0
0 6 2 0 0 -2 0 4 10 0
1 2 2 0 -2 -2 0 4 0 0
4 3 4 0 -2 -4 0 4 2 0
5 0 -2 0 0 0 0 2 11 1
4 0 -2 0 0 0 0 0 9 1
-- End Tiles --

-- Checkpoints --
0 0 0 0 0 10 0
0 0 0 0 0 0 1
-- End Checkpoints --
 
-- Warps --

-- End Warps --