test level
0 0 0 0 0 -10
3 0 0 0 0 0 0 0 3
4 0 0 0 0 0 0 0 0
1 3 2 0 0 0 0 0 11
1 1 2 0 0 0 0 0 1
3 5 3 2 0 -2 -1 0 9
2 6 3 0 0 -2 -1 4 1
2 3 0 0 0 4 0 -4 9
4 4 1 0 0 -2 -1 4 0
4 5 0 0 1 -2 0 4 0
4 6 -2 0 1 -2 0 4 0
1 1 0 -2 0 2 0 0 6
4 2 0 -2 0 2 0 0 8
1 0 -2 -2 0 2 2 0 2
5 0 -2 0 1 -2 0 2 8
2 1 2 2 0 0 0 0 1
0 0 3 2 0 -6 -1 0 1
3 4 3 4 0 -6 -1 0 9
1 6 3 4 0 -4 -1 0 11
